111g111111111111111111111
1P01000010000000000000001
1001000010000100000000001
100100001000010000C000001
100000N010000100000000001
1111000011000100010000001
100000C010000100000000N01
10000000100N0100000100001
1101111110000100000000001
10000000000001000N000C001
1011111111111100000100001
10111111111111000001000E1
1011111111111111110111111
1000000000000000000111111
1111111111111111111111111